- # # # # # - - -
- # - - - # # # #
- # - - - # - - #
- # # - - - - O #
# # # - # # # O #
# - X - # - # O #
# - X X # - # # #
# P - - # - - - -
# # # # # - - - -