- # # # # # - - -
- # - - - # # # #
- # - - - # - - #
- # # - - - - . #
# # # - # # # . #
# - X - # - # . #
# - X X # - # # #
# S - - # - - - -
# # # # # - - - -
