- # # # # # # - -
# # - - - - # # -
# - . # # X - # -
# - . . X - - # -
# - - # X - - # -
# - - S - # # # -
# # # # # # - - -
- - - - - - - - -
- - - - - - - - -
